NO rs/textures/north.xpm
SO rs/textures/south.xpm
WE rs/textures/west.xpm
EA rs/textures/east.xpm

F 40,70,90
C 15,15,

111111111111
100000000001
100100010001
1000000N0001
100010000001
111111111111
