NO rs/wall.xpm
SO rs/wall.xpm
WE rs/wall.xpm
EA rs/wall.xpm

F 40,70,90
C 15,15,25

111111111111
100000000001
100100010001
1000000N0001
100010000001
111111111111
