1111111111111111111111111111111111
1E10000000000000C00000C00000000001
1100010100100000101001000000010101
1010010010101010001001000100010101
100000000C00C000000000001C10000001
100000000C00C00000P000001C10000001
100000000C00C000000000001C10000001
100000000C00C000000000001C10000001
1111111111111111111111111111111111